11111111
10P00001
100C00C1
110000E1 
11111111