11111111111111111111111111111111111111111111111111
1000000000000000000000000000000000000C000000000001
10000P000000000000000CC000000000000000000000000001
100000000000000000000000000C00000000C0000000000011
10000000000000000111C0000000000000000000C000000001
1000000000000000000000000000000000C000000000000001
1000000000000001111110111111000000000C000001111111
100000000C0000100000000000000000000000000000000001
1000000000000000000000000CC00000000000000000000001
1000000000000000000000C000000000000000000000000001
100000000000100000000000000CC000000000000000000001
10000000000011110000000000000000000000000C00000001
100000000000000000000000000000000000000C0000000001
10000000000000000000001100000000001000000000000001
10000000000000000000001100000000000000000000011111
100000000000000C0000000000CC0000000000000010000001
100000e0000000000000111111111101111111111111111111
10000000000000000000111111111101111111111111111111
11111111111111111111111111111111111111111111111111