11111111111111111111
10P00111100C00001111
100000000CC000000011
1110C000000111100011
10C000000000111C0111
100C00000CC000000111
100000011111100E1111
11111111111111111111