1111111111
1111000111
1000000001
1000000001
10000C0001
10000E0001
1000P00001
10000C0001
10000C0001
1111111111