11111111111111111111111111111111111111111111111
1CC000000000000C00000C00000C0010000000000000001
110100111000C000C0C00C0C00000010000000000000001
1001001CCCC000000000C0C0000C0010000000000000001
1000001CCCC0C000C0000C00000C0010000000000000001
10000000111111111111111111111110000000000000001
100000CC00P000000000000000000000000000000000001
10000000000000000001000000000000000000000000001
100000000C0000000001000000000000000000000000001
100000000C0000000001000000000000000000000000001
100000000C0000000010100000000000000000000000001
1000000000C000000100010000000000000000000000001
1011000C000000001001001000000000000000000000001
10100000000C00000101010000000000000000000000001
11000010000000000100010000000000000000000000001
10000100000C00001000001000000000000000000000001
10000010000000000100010000000000000000000000001
10000010000000000100010000000000000000000000001
10000111000000000100010000000000000000000000001
10000000000000010000001000000000000000000000001
10000000000000000100010000000000000000000000001
10000001000000011100011000000000000000000000001
10000001000000001101001000000000000000000000001
10000010000000000000000110000000000000000000001
10000100000000000000100000000000000000000000001
100000000000000000011C0000000000000000000000001
10000000000000000001110000000000000000000000001
1000000000000000011111C000000000000000000000001
10000000000000000111111100000000E00000000000001
11111111111111111111111111111111111111111111111