11111111111111111111
11P100C0000000C00111
101000000C0011100001
100000CCCCC000000001
10000C000C000C000001
100C0000C000000000E1
11111111111111111111