11111111111111111111
10P000C0000000C00111
100000000C0011100001
100000CCCCC000000001
10000C000C000C000011
100C0000C000000001E1
11111111111111111111