111111111111
1CC000000011
110100111001

1E01001CCCC1
1000001CCCC1
100000001111
100000CC00P1
111111111111