
1111111111111
1CK0000000001
1CC0000E00001
1000000000001
10000000000P1
1111111111111