11111111111111
10000000000001
10000000000001
10000000000001
10000E00000001
10000000000001
10000CCC0000P1
01111101111111