1111111111111111
1CC000000011
1CC0000E00001
10000000000011
10000000000P1111
1111111111111111