1111111111111
1C00000000001
1CC0000000001
1000000000001
10000000000P1
1111111111111