1111111111111111111
1CC00000001000C0001
1101001110000000001
1E01001CCCC00000001
10C0001CCCC00000001
1000000011111111111
100000CC00PP0C00001
1111111111111111111